20
10
W,W,W,W,W,W,W,W,W,W,W,W,W,W,W,W,W,W,W,W,
W,W,W,W,W,W,W,W,w,W,W,W,W,W,W,W,W,W,W,W,
W,W,W,W,W,W,W,T0,W,W,W,W,W,W,W,W,W,W,W,W,
W,W,W,W,W,W,_,_,_,W,W,W,W,W,W,W,W,W,W,W,
W,W,W,W,H0,B0,B1,_,W,W,W,W,W,W,W,W,W,W,W,W,
W,W,W,W,W,W,W,H1,W,W,W,W,W,W,W,W,W,W,W,W,
W,W,W,W,W,W,W,W,W,W,W,W,W,W,W,W,W,W,W,W,
W,W,W,W,W,W,W,W,W,W,W,W,W,W,W,W,W,W,W,W,
W,W,W,W,W,W,W,W,W,W,W,W,W,W,W,W,W,W,W,W,
W,W,W,W,W,W,W,W,W,W,W,W,W,W,W,W,W,W,W,W,
